1111111111111111111111111111111111
1000000001011100001111100000110001
100E00E00000100000000000P000000001
1001000000100000000001111000000001
1000000000000000000000000000000001
100001110000000000000E000000000001
1000000000000000001111110000000001
1000000100000000000000000000000001
10000000000000E0000000000000000001
1000000000010000011111111111110001
1000000000000C00000000000000000001
1111111111111111111111111111111111