111111111111111
10000P000C00001
100E00E00000C01
100C000000C0001
100000000000001
111111111111111