111111111111111111111111
100E01000C111C0001100P01
100C0000C111110001100001
1111110011111111000C0011
100000001111000C00010001
100111110000000000000001
1000C00000C0011111000C01
111111111111111111111111